######
#....#
#.#@.#
#.B+.#
#.X+.#
#....#
######