  ####   
###..####
#.....B.#
#.#..#B.#
#.X.X#@.#
#########