######
#....#
#.#..#
#.@+.#
#.++.#
#....#
######