######
#....#
#.#..#
#..+.#
#.++.#
#....#
######