  ####   
###..####
#.......#
#.#..#..#
#.+.+#..#
#########