  ####   
###..####
#.......#
#.#.@#..#
#.+.+#..#
#########